F 97,247,67
NO ./textures/amongus.xpm
SO ./textures/amongus.xpm
WE ./textures/jib.xpm
EA ./textures/jib.xpm
C 235,115,115

  1111 1111111111111
 11001 100S0000000011
111000100000000E000111
 11000001111100000011
  111111     1111111