F 97,247,67
NO ./textures/texture1.xpm
SO ./textures/texture2.xpm
WE ./textures/texture3.xpm
EA ./textures/texture4.xpm
C 235,115,115

  111111111111111111
 110000000S0000000011
1110000000000000000111
 11000001111100000011
  111111     1111111