F 97,247,67
NO ./textures/water1.png
SO ./textures/water2.png
WE ./textures/water3.png
EA ./textures/water4.png
C 235,115,115

  111111111111111111
 11000000000000000011
1110000000000000E00111
 1100001111110000011
  111111     1111111