R 1920 1080

NO ./textures/photo5.png
SO ./textures/photo6.png
WE ./textures/photo5.png
EA ./textures/photo7.png

S ./textures/photo1.png
F 112,110,106
C 29,31,47

		1111111111111111111111111
		1000000000110000000000001
		1000000000110000000000001
		1000000000110000000000001
		1000000000000000000000001
		1000000000000000000000001
		1000000000110000000000001
		100000000011000000E000001
		1000000000110000000000001
		1000000000110000000000001
111111111011000001110000001000001
1001000000000000000001000000011111
11111111101100000111000000000000111111
10000000001100000111011111011000011
11110111111111011100000010001111111
11110111111111011101010010000000001
11000000110101011100000010000000001
10001000000000001100000010000000001
10000000000000001101010010001111111
11000001110000011101111101111000111
11110111 1110101 101111010001111111
11111111 1111111 111111111111
