F 97,247,67
NO ./textures/amongus.xpm
SO ./textures/amongus.xpm
WE ./textures/jib.xpm
EA ./textures/jib.xpm
C 235,115,115

  1111 1111111111111
 110001000S0000000011
1110000000000000000111
 11000001111100000011
  111111     1111111