F 173,164,140
NO ./textures/wall2.xpm
C 225,30,0
SO ./textures/wall2.xpm
WE ./textures/wall2.xpm
EA ./textures/wall2.xpm

1111111111
1N00000001
1000100001
1001 10001
1111 1111